Para calar a boca: Ricino
Para lavar a roupa: Omo
Para viagem longa: Jato
Para difíceis contas: Calculadora
Para o pneu na lona: Jacaré
Para a pantalona: Nesga
Para pular a onda: Litoral
Para lápis ter ponta: Apontador
Para o Pará e o Amazonas: Látex
Para parar na Pamplona: Assis
Para trazer à tona: Homem-rã
Para a melhor azeitona: Ibéria
Para o presente da noiva: Marzipan
Para Adidas: O conga nacional
Para o outono a folha: Exclusão
Para embaixo da sombra: Guarda-sol
Para todas as coisas: Dicionário
Para que fiquem prontas: Paciência
Para dormir a fronha: Madrigal
Para brincar na gangorra: Dois
Para fazer uma toca: Bobs
Para beber uma coca: Drops
Para ferver uma sopa: Graus
Para a luz lá na roça: Duzentos e vinte volts
Para vigias em ronda: Café
Para limpar a lousa: Apagador
Para o beijo da moça: Paladar
Para uma voz muito rouca: Hortelã
Para a cor roxa: Ataúde
Para a galocha: Verlon
Para ser moda: Melancia
Para abrir a rosa: Temporada
Para aumentar a vitrola: Sábado
Para a cama de mola: Hóspede
Para trancar bem a porta: Cadeado
Para que serve a calota: Volkswagen
Para quem não acorda: Balde
Para a letra torta: Pauta
Para parecer mais nova: Avon
Para os dias de prova: Amnésia
Para estourar pipoca: Barulho
Para quem se afoga: Isopor
Para levar na escola: Condução
Para os dias de folga: Namorado
Para o automóvel que capota: Guincho
Para fechar uma aposta: Paraninfo
Para quem se comporta: Brinde
Para a mulher que aborta: Repouso
Para saber a resposta: Vide-o-verso
Para escolher a compota: Jundiaí
Para a menina que engorda: Hipofagin
Para a comida das orcas: Krill

Para o telefone que toca
Para a água lá na poça
Para a mesa que vai ser posta
Para você, o que você gosta
Diariamente